# Sun Apr 19 06:43:14 CEST 2015
players 3
rows 33
cols 120
m .................%.......................%%%%.........%.................%%%...*....%%.................%%.......*......%.
m .*...............%..........*...........%%.%%%........%%....%.......*....%%%...%%%%%%.................%..............%%.
m .................%.....................%%...%%.........%%%%%%..............%%%%%%.*...*...............%...........%%%%..
m ...............%%%......*.............%%.....%%.........%..............*..*....*......................%..........%%%....
m .*...........%%%...................%%%%.......%%......................................................%.........%%......
m ...*.....%%%%%........%...........%%...........%%....................*.....*................%.................%%%.......
m .........%%%...........%........*............*..%%....*.............%%...*.........*%%.....%%................%%...*.....
m ..........%%...........%%%.......................%%..............%%%%.............%%%%%%.%%......%.........%%%*.........
m ...%......*%%....0.......%%%%....................%%%%%..........%%..............%%%....%%%.......%.........%%...........
m ..%%........%%..............%%%%%.....*.............%...........%..............%%................%................*.....
m ..%%*........%.................%%..............................%..............%%.......*.........%......................
m .%%%%.....*...%..*..............%%%........%%................*%%..............%..................%.....................*
m %%.%%%........%%....%............%%%...%%%%%%.................%..............%%..................%......................
m %...%%.........%%%%%%..............%%%%%%........*............%...........%%%%...................%.....................%
m .....%%......*..%................*............................%..........%%%...................%%%....................%%
m ......%%.....................................*................%.........%%...........***.....%%%..........*........%%%%.
m .......%%...........................................%.................%%%................%%%%%........%...........%%....
m ..*.....%%...*..............%%..............%%.....%%................%%............*.....%%%..*........%................
m ..*......%%..............%%%%.............%%%%%%.%%......%.........%%%....................%%...........%%%..............
m .........%%%%%..........%%..............%%%....%%%......*%.........%%..............%.......%%....2.......%%%%...........
m ............%..........*%..............%%....**..........%........................%%........%%..............%%%%%.......
m .......................%..............%%........*........%........................%%.*.......%.................%%.......
m ...%%..........*.*....%%..............%..................%.....................*.%%%%.....*...%........*........%%%.....
m %%%%%.................%..............%%..................%......................%%.%%%........%%....%............%%%..*%
m %...................*.%...........%%%%........*..........%.........*..........*%%...%%.........%%%%%%..............%%%%%
m .................*....%..........%%%...................%%%....................%%.....%%.........%.......................
m ............*.........%.*.......%%...................%%%.........*.........%%%%.......%%................................
m ............%...*.............%%%................%%%%%........%...*.......%%...........%%...............................
m ....%%.....%%................%%..................%%%*..........%........................%%........*.........%%..........
m ..%%%%%%.%%......%.....*...%%%....................%%...*..*....%%%.......................%%..............%%%%.....*.....
m %%%....%%%.......%.........%%..............%.......%%....1.......%%%%....................%%%%%..........%%..............
m %................%.*.........*............%%........%%..............%%%%%...................%...........%..............%
m .................%............*...........%%.........%.................%%..............................%...*..........%%
