# Sun Apr 19 06:46:10 CEST 2015
players 4
rows 68
cols 196
m .....%%%*...................%%%%..%%%%....................%%%%.....%%%................*....%%..........%%%....................%%%%..%%%%.............*......%%%%.....%%%.....................%%.....
m ......%%.....................%%%%%%%%............*........%%%......*%%%.............*......%%%..........%%*....................%%%%%%%%.*...................%%%.......%%%...............*....%%%....
m ......%%%..................*.%%%%%%%.*...............................%%........%%.........%%%%........*.%%%..*.................%%%%%%%...*...........................*.%%........%%.........%%%%....
m .......%%...................%%%%%%%..................................%%%...*...%%%.......%%%%............%%...................%%%%%%%.........*........................%%%.......%%%.......%%%%.....
m ......*%%%.......%%%%%%%%%%%%%%%%%....................................%%%.......%%%.....%%%%.............%%%.......%%%%%%%%%%%%%%%%%.................................*..%%%.......%%%.....%%%%......
m .......%%%%.*...%%%%%%%%%%%%%%%%%%....................................%%%%.......%%%...%%%%..............%%%%.....%%%%%%%%%%%%%%%%%%....................................%%%%....*..%%%...%%%%.......
m .......%%%%....%%%%%%%%%%%%%%%%%%%.....................................%%.........%%%%%%%%............*..%%%%....%%%%%%%%%%%%%%%%%%%...........*.................*.......%%.........%%%%%%%%........
m %%%...*.%%%%...%%%%%............%%....................................%%%..........%%%%%%.........%%%.....%%%%...%%%%%............%%...*................................%%%..........%%%%%%.........
m %%%%....%%%%...%%%%.............%%....................................%%...........%%%%%%........%%%%%....%%%%...%%%%..........*..%%...............................*....%%...........%%%%%%*.......%
m %%%.....%%%.....%%%%............%%%..................................%%%.......*..%%%...........%%%%%.....%%%.....%%%%........*...%%%.............................*....%%%..........%%%...........%%
m %.......%%.......%%%*...........%%%..................................%%%..........%%%..........%%%%.......%%.......%%%............%%%..................................%%%..........%%%..........%%%
m ..................%%%...........%%%................................%%%%%.........%%%.....*...%%%%%..................%%%...........%%%................................%%%%%.........%%%.........%%%%%
m ..................%%%..........%%%.............%%..........%%%*..%%%%%%..........%%%........%%%%%...................%%%..........%%%...........**%%..........%%%...%%%%%%..........%%%........%%%%%.
m ...................%%%........%%%..........%%%%%%%.........%%%%%%%%%%......*....%%%.........%%%%%....................%%%......*.%%%..........%%%%%%%.........%%%%%%%%%%...........%%%.........%%%%%.
m ........%...*.....*%%%.......%%%*.........%%%%%%%%%%.........%%%%%%.............%%%.........%%%%%%........%..........%%%.......%%%..........%%%%%%%%%%.........%%%%%%..*..........%%%.........%%%%%%
m %%.....%%...........%%%......%%%..........%%%%...%%%...*.......%%..............%%%..........%%%%%%%%.....%%..*........%%%.*..*.%%%..........%%%%...%%%........*..%%..............%%%..........%%%%%%
m %%%%%%%%%%..........%%.......%%..........%%%%.......*..........%%%.............%%%..............%%%%%%%%%%%%..........%%.......%%..........%%%%..................%%%.............%%%..............%%
m %%%%%%%%%%%..............................%%%%............*.....%%%......*......%%%................%%%%%%%%%%%..............................%%%%..................%%%......*......%%%........*.......
m .%%%%%%.%%%%.............................%%%..........*........%%%.....*1*.....%%%................*%%%%%%.%%%%.............................%%%...................%%%.....*3*.....%%%..............*.
m ..%%%....%%%%............................%%.....................%%......*.......%%..................%%%....%%%%...................*........%%.....................%%......*.......%%..*.............
m ..........%%%%..........................%%%.....................%%..............%%%%%%%%%%%.............*...%%%%..........................%%%.....................%%..............%%%%%%%%%%%.......
m ..........*%%%%.........................%%..............*.......%%%.............%%%%%%%%%%%%...........*.....%%%%.........................%%.......*..............%%%.............%%%%%%%%%%%%......
m ......*.**..%%%%.......................%%%......................%%%.............%%%%%%%%%%%%%.................%%%%.......................%%%......................%%%.............%%%%%%%%%%%%%*....
m .............%%%%......................%%.......................%%%......*.....%%%.........%%%..............*..%%%%......................%%.......................%%%.....*......%%%.........%%%....
m %............%%%%.....................%%%...........%........*..%%%%%.........%%%...........%%%%.%%............%%%%................*....%%%...........%...........%%%%%.........%%%.*.........%%%%.%
m %%............%%%%%%.........%%%%....%%%%..........%%%%%%%%%%%%%%%%%%%%.......%%%........*...%%%%%%%............%%%%%%.........%%%%....%%%%..........%%%%%%%%%%%%%%%%%%%%.......%%%............%%%%%
m %.............%%%%%%%%%%...%%%%%%%%%.%%%%..........%%%%%%%%%%%%%%...%%%%%%....................%%%%%.............%%%%%%%%%%...%%%%%%%%%.%%%%.....*....%%%%%%%%%%%%%%...%%%%%%....................%%%%
m ..............%%%%%%%%%%%%%%%%%.%%%%%%%%...........%%%%%%%%%%%%%......%%%.......................................%%%%%%%%%%%%%%%%%.%%%%%%%%...........%%%%%%%%%%%%%......%%%.........*...............
m .............%%%...*..%%%%%%%......%%%%%*....................%%.............................................*..%%%..*...%%%%%%%......%%%%%.....................%%....*...*..........................
m ............%%%...........%..........%%%......................................................................%%%....*......%..........%%%........................*.................................
m *.......%%%%%%............................................................................................%%%%%%..............*........................*...........*...................*.......*....
m .......%%%%%%%.*.........................................................................................%%%%%%%....*....................................................*..........................
m ........%..........................................................................................*......%....................*....................................................................
m ..........................................**.......................................................................................*.........*...........*..........................................
m ..............................................*..............................*....................................*..........................................*.........*............................
m .*...................................................*...................................%.........................*...........................**.........*.................*.....*.....*..%........
m ......*.........................................................*...................%%%%%%%.....................*....................................................................*%%%%%%%.......
m .........................................*.............*...............*............%%%%%%..........*...................*.......*...............*.....................................%%%%%%........
m .*..........................................*.............%%%..........%...........%%%.......*..............................................................%%%..........%..........*%%%...........*
m ...................................%%...........*.........%%%%%......%%%%%%%......%%%.....*..........*...............................%%.....................%%%%%......%%%%%%%...*..%%%.............
m .........*...............%%%......%%%%%%%%%%%%%...........%%%%%%%%.%%%%%%%%%%%%%%%%%............*..........................%%%......%%%%%%%%%%%%%...........%%%%%%%%.%%%%%%%%%%%%%%%%%..............
m %%%%....................%%%%%%...%%%%%%%%%%%%%%..........%%%%.%%%%%%%%%...%%%%%%%%%%.............%%%%%....................%%%%%%...%%%%%%%%%%%%%%*.........%%%%.%%%%%%%%%...%%%%%%%%%%......*......%
m %%%%%.*..........%%%.......%%%%%%%%%%%%%%%%%%%%..........%%%%....%%%%.........%%%%%%............%%%%%%%............%%%.......%%%%%%%%%%%%%%%%%%%%..........%%%%....%%%%.*.......%%%%%%............%%
m %.%%%%...........%%%.........%%%%%...........%...........%%%.....................%%%%............%%.%%%%...........%%%.........%%%%%...........%..........*%%%.....................%%%%......*.....%
m ....%%%.........%%%...*..*.....%%%........*...*..........%%......................%%%%.................%%%.........%%%............%%%.......................%%......................%%%%...........*.
m .....%%%%%%%%%%%%%.............%%%...*..................%%%.......................%%%%............*....%%%%%%%%%%%%%......*......%%%.............*......*.%%%...*............*......%%%%............
m ......%%%%%%%%%%%%.............%%%...*..................%%.........................%%%%.................%%%%%%%%%%%%.............%%%......................%%....................*....%%%%...........
m .......%%%%%%%%%%%..............%%.....................%%%..........................%%%%.................%%%%%%%%%%%..............%%.....................%%%..*.......................%%%%..........
m ................%%.......*......%%.....................%%..........*......*..........%%%%....%%%.................*%%.......*......%%.....................%%...*........................%%%%....%%%..
m ................%%%.....*0*.....%%%...................%%%.............................%%%%.%%%%%%.................%%%.....*2*.....%%%...................%%%.........................*...%%%%.%%%%%%.
m .*..............%%%......*......%%%..................%%%%..............................%%%%%%%%%%%................%%%......*......%%%..............*...%%%%....*.........................%%%%%%%%%%%
m %%........*.....%%%.............%%%..................%%%%..........%%.......%%..........%%%%%%%%%%%%..............%%%.............%%%..................%%%%..........%%.......%%..........%%%%%%%%%%
m %%%%%%..........%%%..............%%...........%%%...%%%%..........%%%......%%%..*........%%.....%%%%%%%%......*...%%%..............%%...........%%%...%%%%..........%%%.*....%%%.....*.....%%.....%%
m %%%%%%.........%%%.....*.......%%%%%%.........%%%%%%%%%%*.........%%%.......%%%..........%........%%%%%%*........%%%......*......%%%%%%.........%%%%%%%%%%..........%%%.......%%%..........%........
m .%%%%%.........%%%...........%%%%%%%%%%.........%%%%%%%..........%%%........%%%....................%%%%%.........%%%...........%%%%%%%%%%.........%%%%%%%..........%%%........%%%..........*........
m .%%%%%.*......%%%..........%%%%%%...%%%..........%%..*..........%%%..........%%%...................%%%%%........%%%..........%%%%%%...%%%..........%%...........**%%%..........%%%....*.............
m %%%%%.........%%%.........%%%%%........*...........*...........%%%...........%%%...............*..%%%%%*........%%%.........%%%%%.....................*..........%%%...........%%%..................
m %%%..........%%%..........%%%..............*...................%%%.......*....%%%.......%%.......%%%%..........%%%...*......%%%.....*...........*..*.............%%%............%%%.......%%.......%
m %%...........%%%..........%%%..................................%%%............%%%%.....%%%.....%%%%%...........%%%..........%%%.......*..........................%%%............%%%%.....%%%.....%%%
m %.*......%%%%%%...........%%...................................*%%.............%%%%...%%%%....%%%%%........%%%%%%...........%%.....................*..............%%.............%%%%...%%%%....%%%%
m ..*......%%%%%%..........%%%.*..................................%%.....*...*..%%%%%...%%%%.....%%%*........%%%%%%.*........%%%.............................*......%%............%%%%%...%%%%.....%%%
m ....*...%%%%%%%%..*......%%....................*................%%%%%%%%%%%%%%%%%%%....%%%%...............%%%%%%%%.........%%.....................................%%%%%%%%%%%%%%%%%%%....%%%%.......
m .......%%%%...%%%.......%%%%...................*................%%%%%%%%%%%%%%%%%%.....%%%%..............%%%%..*%%%.......%%%%....................................%%%%%%%%%%%%%%%%%%.....%%%%.......
m ......%%%%.....%%%*....*.%%%.*........................*.........%%%%%%%%%%%%%%%%%.......%%%.............%%%%.....%%%.......%%%....................................%%%%%%%%%%%%%%%%%.......%%%.......
m .*...%%%%..*....%%%.......%%%..................................%%%%%%%...................%%......*...*.%%%%.......%%%.......%%%..................................%%%%%%%...................%%.......
m ....%%%%.........%%........%%.................................%%%%%%%....................%%%..........%%%%.........%%........%%...*..*..........................%%%%%%%....................%%%......
m ....%%%....................%%%.......%%%.....................%%%%%%%%.....................%%..........%%%...................*%%%.......%%%.....................%%%%%%%%.....................%%......
m .....%%.....................%%%.*...%%%%....................%%%%..%%%%.......*............%%%..........%%.....................%%%.....%%%%....................%%%%..%%%%.......*..........*.%%%.....
