# Sun Apr 19 06:37:42 CEST 2015
players 2
rows 76
cols 122
m ...%%..........%........%%%%%*..................%%...*...................%%...............%%%%.............%.........%%...
m ....%...........%...............................%%...........%%...........%%........%%.%%%%.................%........%....
m ....%............%%%...................*........%%......*...%%%%%...........%%...*...%%%.....................%....*..*....
m ....%.....................................*....%...........%%...%%%%.........%%.......%......................%%...........
m ...*%%........................*..*...*%%......%...........%%.......%%.........%%......%%.....................%............
m .....%..*............................%%......%............%........................*..%%................*....%.*...*......
m .....%...............*.......*.......%......%....*.....%%%.............................%*.............*....*.%............
m .....%%%%...........................%...........*0*....%.%%............................%.....................%............
m *.......%%%..................%%....%%............*........%%...........................%.....................%............
m ..........%%.................%.....%....*..................%...........................%%...................%%............
m ...........%.*..............%......%%....*..................%..*.....%%...................................................
m ...........%................%......*%.................*......%........%%%.%%%%%...................%%..........*...........
m ...........%%..............%........%%.......%%..............%%.........%%....%%................%%.%%%%.................%%
m ............%.......%.....%%.........%........%%%.............%.................%%..............%................%%%%%%%%%
m %...........%%......%%%.%%%..........%%*........%%%..........*...................%%%...........%%.........................
m %...........%%........%%..........*...%..*......%%...*..............*..............%...........%.........................*
m .%..........%%........%%.............%..........%%.................................%...........%..........................
m ............%.........%%.............%..........%*.................................%..........%...........................
m ...........%.*........%%............%%.........%%.....................*.............%.........%.............*.............
m .......%%%%%......*...%%...*........%..........%............................*................%%...........................
m .................*1*..%%..*0*......%%..........%............%...........%...*................%.......*.........%.*........
m ..................*...%%...*.......%..........%%............%..........%.............*.......%..............%%%%..........
m .......*..............%%...........%..........%..**.........%........%%.........%...............*.........%%%.............
m ......................%%.....................%%....*.......%........%%..*.......%........................%................
m ......................%%...............*....%%%...........%........%%........*..%.......................%%...........*....
m ......................%%................%%%%.............%.........%............%%............%.........%...........*%....
m ................%%%%%%%%................%%..............%..........%.............%...........%%........%%............%....
m .......................%%%%%%%...........%.............%*..........%%............%....*...%%%%........*%%.............%...
m .........................%%%%............%............%.............%.....*...*..%......%%%%............%.............%...
m ...%%.................*..................%............%.............%.....*......%%.%%%%....................*.........%...
m .%%%........................*....*.......%.....*.....%..............%%%...........%%%%................................%%..
m %%..........%........................*...%*..........%....*.......*%%.%%%......................*......................%%.%
m ............%......*.....................%...........%............%%....%%%........................................%%%%%%%
m ...........*%............................%%................*....*.%.*.....%*......*...........................*.%%%%......
m .............%*............................%%....................%.........*..............................................
m .............%%%............................%%..................%.......*.......*....*.......%%%..........................
m ...............%%%%..*..*.....*.%%............%................%%...........................%%.%%%........................
m ..................%%%%%........%%.%%%...**...*............................................%%.....%%%.%.*..................
m ....................%.%%%.....%%.....................................................%%%.%%...*....%%%%%..................
m ..*.....................%%%.%%...........................%%................%............%%.........*...%%%%...............
m ..*.......................%%%......................*.....%..................%%............................%%%..........*..
m ........*.................*.............................%....................%%.............................%.............
m ......%%%%.....................................%.......%*......................%%............................%............
m %%%%%%%........................................%%%..*.%%............%...........%............................%............
m %.%%..........................*..................%%%.%%.............%...........%............................%...*......%%
m ..%%.....................*..........%%%%...........%%%..............%...........%.....................................%%%.
m ...%..............................%%%%.%%............%.............%.......*....%....................................%%...
m ...%.............%............%%%%......%............%...........*.%............%............%%%%*..........*.............
m ..*%.............%%.*.......%%%%........%..*.........%%...........%.............%...........%%%%%%%.................*.....
m ....%............%%........%%...........%.............%.....*....%..............%%.........*......%%%%%%%%................
m ....%............%.........%............%%............%.....*...%........*....%%%%....*...........%%.............*........
m ................%%...................*...%...........%%........%.........*.%%%....................%%......................
m ................%....*...................%..........%%....*...%............%%.....................%%......................
m ....*........%%%.........................%.....*...%%........%.............%..........%...........%%.........*..*.........
m ..........%%%%..............%.....................%..........%.*..........%%..........%.......*...%%...*..................
m ..........%.................%.......*.....*......%...........%......*.....%..........%%......*1*..%%..*0*...........*.....
m .............*.............%%.............*...............................%..........%........*...%%...*......%%%%%.......
m ...........................%.........%...................................%%.........%%............%%..........%...........
m ...........................%..........%..................................%..........%.............%%.........%............
m ..........................%...........%......................*..........%%..........%............*%%........%%..........%.
m ..........................%...........%...............................*.%%.........%..............%%........%%...........%
m .........................%%...........%%%..............................%%%...*.....%%..........%%%.%%%......%%...........%
m %%%%%%%%%................%..............%%.................%.............%%%........%.........%%.....%.......%............
m %%..*..............%%%%.%%................%%....%%...*.....%%..............%%.......%%.....*..%..............%%...........
m ................*.....%%...................%%%%%.%%%........%...........*............%.......%................%...........
m ..........................*........................%%........%.*.....................%%......%.........*......%...........
m ............%%................*..%%....................*......%.......................%.....%.................%%..........
m ............%.................*...%*.................*........%%........*............%%....%%..*...............%%%........
m ............%......*..............%.*..........................%%.%....*1*...........%.........*..*..............%%%%.....
m ............%.....................%.............................%%%.....*....%......%.............*.................%.....
m ............%................*....%%...........................%............%...*..%%.....................*.........%.....
m ............%.....................%%......%%..*..**..%%.......%%...........%..*...%%................................%%....
m ...........%%......................%.......%%.........%%%%...%%...........%..........................................%....
m ......*.....%.....................%%%.......%%...........%%%%%..........%%.*..........................%%%............%....
m ....%........%.*...............%%%%.%%........%%...........%%...........%%.......*...............*.......%...........%....
m ...%%.........%.............%%%%...............%%.......................%%...*...............%%%%%........%*.........%%...
