# Sun Apr 19 06:39:11 CEST 2015
players 3
rows 36
cols 150
m ....................................*%.............%..............................................%..*..........*.......*..%..........................
m ......................%.............%........*.....%...........%%%%.....*..........................%............%.........%...........................
m ..%%.........*..%%%%%%%.............%.......*1*.....%.........%%..%%%%%%.........*.................%%%%%%%%%%%%%%%........%...........................
m ..%..........%%%%...................%*.......*......%.............*................................%%%%%..................%%..........................
m .%%...............................*.%%...........................................................*.%......................*%..........*...............
m .%.....*..........................%%%%%..............................*............................%.........................%..................*......
m %%.........................%%%%%%%%...%%%.......*........................*........................%.........................%...........%.............
m %.................*........%%%%%%%......%%%..............*.............*.......%%%%%%...*............................*.............*....%%............
m %...*.....................................%%%...........*1*................%%%%.....*%%..................................................%...........%
m ......*.....................................%%%..........*................%...........%%.................................................%...........%
m %.......................**....................%%%.........................%............%%.....................*..........................%....*......*
m %...*........*.................................%%........................%.............................*.................................%............
m .%..............................................%.......*................%...............................................................%............
m .%...........%%%%*.................*.....*.......%..*.........%.........%.................................................%...*.........%........*....
m ..%.........%%..%%%%%%...........................%%%%%%%%%%%%%%%........%.............................%%............%%%%%%%.......*.....%...*...*0*...
m ..%..............................................%%%%%..................%%...........*................%..........%%%%...............*...%........*....
m .....................*...........................%.......................%...........................%%.................................%%............
m ..*.....................*.......................%.........................%..........................%................................%%%%%...........
m ..........................**....................%.........................%...........%.............%%.........................%%%%%%%%...%%%.........
m .......*.....................%%%%%%.....................................*.............%%..........*.%..........................%%%%%%%......%%%.......
m ......*0*..........*.....%%%%......%%......................................*...........%....*......%%.........................................%%%.....
m .......*................%...........%%.................*.......*.....*.....*...........%...........%...........*...............*................%%%...
m ........................%............%%........................*.........*.............%............%.............................................%%%.
m .......................%..............*..........*......*..............................%............%..................*...........................%%.
m ...................*...%...............................................................%.............%..............................................%.
m ............%.........%.................................................%*............%........*.....%...........%%%%................................%
m %%%%%%%%%%%%%%........%.............................%%............%%%%%%%.............%.......*2*.....%.........%%..%%%%%%...........................%
m %%%%.........*........%%...*........................%..........%%%%...........*.......%........*......%..............*....*..........................%
m .........*.............%....................*......%%.................................%%..................*..........*...............................%
m ...*........*...........%..........................%................................%%%%%...........................................................%.
m ........................%...........%.............%%..*......................%%%%%%%%...%%%.........................................................%.
m ....................................%%............%.......*........*.........%%%%%%%.*....%%%........*.....*.............*.......%%%%%%...............
m ............*.......................*%...........%%..*............*.........................%%%...........*2*................%%%%.*....%%.............
m .........*...*.........*.............%...........%.*............*.............................%%%..........*................%...........%%.....*......
m .....................................%*...........%.............................................%%%.........................%............%%...........
m ..........................*..........%............%..............................................%%........................%................*.........
