# Sun Apr 19 06:44:22 CEST 2015
players 4
rows 48
cols 136
m .................................*......*................*...............*.....................*..........*.............................
m ...............*...............................................................................................................*........
m ....................................................................**.......................................*.....*....................
m ..................................*.....................................................................................................
m ...............................................................................*.........................................*..............
m ............................*..........................*......................................................*.........................
m ......*.............%%%%..........................*...........................*.................................%%%%....................
m ..................%%%%.%...........................*...................................*........................%.%%%%..................
m ...............%%%.................................................................................................*..%%%...............
m .............%%...........................*.........*.....................*..................*...........................%%.............
m .........................................*0*...............%.....*..........%...............*3*.........................*...............
m ...................................%......*...............%%...............*%%...............*......%.............*...........*.........
m ...................................%......................%..................%......................%..................*................
m ............*...*...........*......%*...........%......................................%............%......*.......*....................
m ...........................*0*.....%%...........%.................................*....%*..........%%.....*3*...........................
m *...........................*.......%..........%...............*.....................*.*%..........%.......*............................
m ....*.....%%.*............................*.................................................................................%%*.........
m ...........%...........%%......................................................................................%%...........%...........
m ...*.......%%...........%%............................*...*...................................................%%...........%%...........
m ............%.............%%........*...............................*.......................................%%.............%............
m ............%..............%%%....*......................................................*................%%%..............%............
m .............%.......*.......%%%.....*...*.............*.............*........................*.........%%%...............%..*..........
m ..........*..%.................%%%.......*............................................................%%%.................%.............
m .............%............*.....%%.*..................................................................%%..................%.............
m .............%..................%%....................................................................%%..................%.............
m ........*....%.................%%%.......................*.............*...................*..........%%%........*........%.........*...
m .............%...........*...%%%.......................................................*.*..............%%%.....*.........%.............
m ............%..............%%%...............................................*............................%%%..............%............
m ............%.............%%.......*..................................*..........................*..........%%.............%.*....*.....
m ...........%%...........%%....................................................................................%%...........%%........*.*
m .........*.%...........%%....................*......................................*..........................%%...*.......%...........
m .......*..%%..............................................................................................................*.%%..........
m ............................*.......%..........%........................................%..........%.......*..........*..*.......*......
m .....*.....................*1*.....%%...........%......................................%...........%%.....*2*...............*...........
m ........*...................*......%............%......................................%.*..........%......*............................
m .................*.................%......................%..........*.......%......................%...............*................*..
m ...................................%......*......*........%%................%%...............*......%.............*.....................
m .........*..............*................*1*...............%................%...............*2*.......................................*.
m .............%%...........................*...........................*......................*...........................%%.............
m ...............%%%..*......*........................................*..................*..............................%%%...............
m ..................%%%%.%...*.................*.....................*............................................%.%%%%...............*..
m ....................%%%%......*..................................*..............................................%%%%....................
m ...................................................................*....................................................................
m ..*...................................*............................*........*...........................................................
m ........................................................................................................................................
m ............*......................................................................*...........*...................*....................
m ......................................*.................*...............................................*...............................
m .....................................*.............................................................................*....................
