# Sun Apr 19 06:33:17 CEST 2015
players 2
rows 42
cols 196
m ...........%%%%%..........%%....%*.....................................%............%.......%..........%*......%............%...........................*.*...*....%....%%..........%%%%%...........
m ...........%...................%%...........................%%...*..................%.......%..........%.......%...*.......*..........%%...........*...............%%......*............%..........*
m ..........%.....................%........................%%%%........................%.....%............%.....%...............*....*...%%%%.......................*%.....................%..........
m .........%......................%.....................%%%%.*.........................%.....%............%.....%.........................*.%%%%......*..............%.........*............%.........
m .........%...........%...............................%%%.....*........*..............%%...%%............%%*..%%.............*...............%%%..........*....................%.........*.%.........
m .....................%...............................%............%...................%...%..............%.*.%...................%............%...*.........*.................%.....................
m .........*...........%...................%...........%...........%%*.........%%.......%%.%%..........*...%%.%%.......%%.....*....%%...........%...........%...................%..........*..........
m ......*.......*......%................*..%%%.........%..........%%........*...%%%%%...%%%%%......*.......%%%%%...%%%%%............%%..........%.*..*....%%%...................%.....................
m .....................%.....................%%%.......%.........%%.................%%%%....%%%%%%%%%%%%%%%%.*..%%%%.................%%.........%.......%%%...........*.........%........*............
m ....................%..*...........*..........................%%.....................................................*..............%%.........................................%....................
m .*.......*.........%.........................................%%......................................................................%%.........................................%...................
m ...........%......%.*.......%%...............................%..........%%...............*........*.....*.................%%..........%...................*...........%%.........%......%...........
m .........%%.......%%.........%....................................*.......%..............................................%.......................*.........*..........%.........%%.......%%.........
m ......%%%..........%...0.....%%..*.........................................%..........*...........*.........*...........%............................................%%.....1...%..........%%%......
m ...%%%.............%...........%%........0....................**.....*......%..........................*...............%..................................1........%%...........%.....*.......%%%...
m %%%.................%............%%...........................%...........*..%.........*..............*...............%..............%.**...*.*...............*..%%............%.................%%%
m ....................%..............%........................%%%%%.............%...............................*.*....%.............%%%%%........................%..............%....................
m ...............*....%%%............%%%....................%%%....%%............%%.................*................%%............%%....%%%...........*........%%%.........*..%%%....................
m .......................%%...........%%%%%%%%%%..........%%%........%...........%%.........%%..*.........%%.........%%...........%.....*..%%%..........%%%%%%%%%%...........%%.......................
m ............**..............................%%%......%%%%..........%............%%...*.%%%................%%%.....%%............%..........%%%%......%%%......................................*.....
m ......................................................%............%...........%%%%%%%%..................*...%%%%%%%%.*.........%............%.................................*.....*..............
m .............%%%%%.....................*............................%.........%....%%..........................%%....%*........%..................................................%%%%%.............
m .*.........*%%%%%.............................................*.............%%........................................%%...........................................................%%%%%............
m ...........%...............%%..........................*.............*.....%..............................*..........*..%..............................................%%...............%...........
m ..........%...........*......%%%%%%..................*...........................................................................................................%%%%%%....*.............%......*...
m .......%%%........................%....................%%%%................*...........................*.................................%%%%...................*%........................%%%.......
m .....%%%%.........................%%...................%..%%%%.....................*..................................................%%%%..%...................%%.........................%%%%.....
m ...................................%........%.........%......%%%.......*............................................................%%%......%.........%........%...................................
m ......................%.....................%%.......%%...............................................*..*.......*...........................%%.......%%....*................%......................
m ......................%......................%%%%%%%%%.....*..........................%................*.....%...*....*..............*........%%%%%%%%%......................%......................
m ............%.........%.......................%%%%%%%....*..*..................*......%......................%.................................%%%%%%%.......................%.........%............
m ....*.......%.........%....................................................%.........%...........*............%.........%...................................*................%..*......%............
m ...........%%.........%..........%............*..................%.........%.*...........................*.........*....%.........%...............................%..........%.........%%...........
m ...........%......*...%.......*..%%..........*.....*.............%.........%...................*.............*..........%.........%..............................%%..........%..........%...........
m ...........%..........%..*........%.*...........................%........*.%.........*................................*.%..........%.............................%...........%......*...%...........
m .%%........%..........%%..........%%.*................%........%%..........%............................................%..........%%........%.............*....%%..........%%..........%........%%.
m %.........%%..........%%........*.%...................%.......%%.........*..%.........%.....*................%.........%...........*%%.......%...................%..........%%..........%%.........%
m ..........%............%%.........%.......*%.........%......................%........%%..............*.......%%........%......................%.........%........%.........%%............%..........
m ........*.%...*.........%........%..........%%*.....%.......................%.......%%........*...............%%.......%.*.....................%......%%..........%........%.............%..........
m ..........%.............%%.......%............%%%%%%%............*..........%......%%........%%......%%.......*%%......%...........*...........%%%%%%%............%.......%%.............%..........
m ........*..%.............%.......%.................%........................%......%.........%........%.........%......%..........*.............%.................%.......%.............%...........
m **.........%.............%%.....%.......................................%%%%%...*..%%.......%%........%%.......%%......%%%%%............................*..........%.....%%.............%...........
