# Sun Apr 19 06:31:43 CEST 2015
players 2
rows 74
cols 130
m ................................%%.......*....................%...........................................................*....%%.
m ................................%%.*....*................*....%......*.........................................................%%.
m ...........................*....%%...*........................%...................................................................
m ............*...................%%....*.......................*.............................................*..................*..
m ............*..*..*.............%%...................................*..............................%%............................
m .............%%.................%%................................................%..................%............................
m .............%.........%..........................................*...%......**.%%%...........%......%%...........................
m .........*..%..........%%.............%%%%%..........%%..*............%......%%%%%%..........%%.......%...........................
m .%%%.......%%...........%%...........%%%..%%......*...%%..............%%..%%%%%*..%%.........%.*......%%..........................
m %%%%%%%..%%%.............%..................%%......*..%%.............%%%%%%.......%........%%.....*...%%%........................
m %%....%%%%%.........*....%................*..%%.........%............%%%%%..........%.......%............%%%%.....%...............
m %........................%...................%..........%%%........%%%%.............%%*....%%*..............%%%%%%%%%%%..........%
m .........................%.............*.....%...........%%%......%%...........0....%%...*.%..................%%%....%%*.........%
m .........................%%..................%..............%%..%%.................%%%....%%..*......................%%.........%.
m ..........................%%.................%................%%%........*.........%%.....%%...................*.....%%........%%.
m ..*...............%.......*%%................%.......*....*.......................%........%%%.......................%%.......%%*.
m .................%%.........%%...............%..................................%%..........%%%%%%%%%................%%........%..
m .................%...........%%.............%%.................................%%%..................%................%%........%..
m .................%............%%%%%%.....*..%%*............................%..%%%......*.............%...............%%........%%.
m ................%%............%....%%%......%%.....%%%......*.*..........%%%%%%%...*.................%%.............*%%.........%.
m ................%....................%%%.....%%%%%%%.%%................%%%%%.%%...........*...........%%%%%%.........%%..*.....%%.
m ................%......................%%......%......%%............%%%%......%%%*........%...........%%%%%%%......*.%%%.....%%%..
m ......%%.......%%%%.....*..............%...............%%.......%%%%%..........%%%%.......%%..........%.....%%.........%%..%%%....
m ...%%%%%%%........%%.*.................%...........*..*.%%.....%%%%...............%%%.....%%%........%..*..*.%%.........%%%%......
m ...%%....%%.........%%...%%%......*....%.................%%%........................%%%.....%%......%%........%%..................
m ..%%.................%%%%%%...........%%.*................%%......*...................%.......%%....%..........%..................
m ..%%..............*...%%..............%%..................%...........................%........%%%.%...........%..................
m ..%...................%............*..%%........*.........%........*..................%........*%%%%..*........%..................
m .%......*............%%...............%%.................%............................%..........%%............%*.................
m .%............*......%................%............*.....%............................%...........%............%%%.......%%.......
m %....................%................%.................%%............................%...........%%%............%%....%%%........
m %...................%%................%.................%..........*............*....*%..........%%%%%%%%..........%%*%%.........%
m %...................%................%%...*............%%...*................*.......*...........%......%%%%........%%%..........%
m %...*..............%%*...............%%...............%%........................................%%...................*...........%
m %.............*..*.%%.........*......%%...............%%..................%....................%%.................................
m %.................%%%................%%..............%%%.................%%....................%..................................
m %%................%%................%%%..............%%.................%%....................%%..................................
m %%................%%*...............%%%..............%%.................%%....................%%..................................
m %.................%%%................%%..............%%%.................%%....................%..................................
m %..................%%................%%...............%%..................%.......*............%%.................................
m %..................%%................%%...............%%.................................*......%%*..............................%
m %...................%................%%................%%........................................%......%%%%....*...%%%..........%
m %...................%%................%.................%.............*...............%..........%%%%%%%%..........%%.%%.........%
m %.....*.............*%................%.................%%................*....*..*...%...........%%%............%%....%%%........
m .%...................%................%..................%............................%.....*.....%.......*....%%%.......%%..*....
m .%...................%%...............%%.............*...%............................%..........%%......*.....%..................
m ..%...................%...............%%..................%.*.........................%.........%%%%...........%..................
m ..%%..................%%..............%%..................%............*..............%.....*..%%%.%...........%..................
m ..%%.................%%%%%%...........%%..................%%..........................%.......%%....%..........%............*.....
m ...%%....%%.........%%...%%%...........%.............*...%%%.*......................%%%.*...%%......%%........%%..................
m ...%%%%%%%........%%...................%................%%.....%%%%...............%%%.....%%%........%.......%%.........%%%%......
m ......%%.......%%%%...................*%...............%%.......%%%%%..........%%%%.......%%..........%.....%%.........%%..%%%....
m .........*......%....*...*.............%%......%.*....%%...*..*.....%%%%......%%%.........%...........%%%%%%%........%%%.....%%%*.
m ................%....................%%%.....%%%%%%%.%%................%%%%%.%%.......................%%%%%%.........%%........%%.
m .*..............%%............%....%%%.*....%%.....%%%...................%%%%%%%.....................%%..............%%.........%.
m ......*..........%............%%%%%%........%%...........*.................%..%%%....................%...............%%........%%.
m ..............*..%.......*...%%.............%%.*...............................%%%.....*............%.....*..........%%........%..
m .....*...........%%.........%%...............%.*................................%%..........%%%%%%%%%...........*....%%........%..
m ..................%.....*..%%................%...............................*....%........%%%.......................%%.......%%..
m ..........................%%.................%..*.............%%%..............*...%%.....%%.........................%%........%%.
m .........................%%..................%..............%%..%%.................%%%....%%.........................%%..*......%.
m ..........*..............%...................%...........%%%......%%...........1....%%.....%........*.........%%%....%%..........%
m %........................%...................%..........%%%........%%%%.............%%.....%%...*...........%%%%%%%%%%%..........%
m %%....%%%%%..............%...................%%.........%............%%%%%..........%.......%............%%%%.....%...............
m %%%%%%%..%%%.............%..................%%..*......%%.............%%%%%%.......%........%%.........%%%........................
m .%%%.......%%..........*%%...........%%%..%%.....*....%%..............%%..%%%%%...%%.........%........%%..........................
m ............%..........%%.............%%%%%..........%%..............*%......%%%%%%..........%%.......%............*..............
m .............%.....*...%..........*.....*.............................%.........%%%*..........%......%%...........................
m .............%%...............*.%%................*.............................*.%................*.%.........................*..
m ..........................*.....%%.....................................*......................*.....%%............................
m .....................*.........*%%.....................................*..........................................................
m ....*...........................%%.................*..........%.....*.................................................*..........*
m .................*..............%%*...........................%..............................*................*................%%.
m ...........*....................%%............................%.........................................*..............*.......%%.
